..............................
..............................
..............................
..............................
.........................&&&&.
.........................&&&&.
.........................&&&&.
...................^.....&&&&.
...................*.....&&&&.
..........^.......############
..........*......##.....######
;;;;;;;;;##########.....######
;;;;;;;;;;;;;;;;;;;.....######
;;;;;;;;;;;;;;;;;;;.....######
;;;;;;;;;;;;;;;;;;;.....######