;.............................
..............................
..............................
;;;;;;;;;;;;;;;;;;;;;;;;;;;;;;
..............................
..............................
..............................
...;;;........................
..............................
;............................&
.............................&
;;;;;;;;;;;;;;;;;;;.....;;;;;;
;;;;;;;;;;;;;;;;;;;.....;;;;;;
;;;;;;;;;;;;;;;;;;;.....;;;;;;
;;;;;;;;;;;;;;;;;;;.....;;;;;;