;;;;;;;;;;;;;;;;;;;;;;;;;;;;;;;;;;;;;;;;;;;;;;;;;;;;;;;;;;;;;;;;;;;;;;;;;;;;;;;;;;;;;;;;;;;;;;;;;;;;;;;
;..................................................................................;;;;;;;;;;;;;;;;;;;;
;...................................................................................;;;;;;;;;;;;;;;;;;;
;....................................................................................;;;;;;;;;;;;;;;;;;
;....................................................................................;;;;;;;;;;;;;;;;;;
;...................................................................;;;;;;;;;;;......;;;;;;;;;;;;;;;;;;
;...............................................................;;;;;;;;;;;;;;;;.....;;;;;;;;;;;;;;;;;;
;.............................................................;;;;;;;;;;;;;;;;;;.....;;;;;;;;;;;;;;;;;;
;...................................;;;;;;..................;;;;;;;;;;;;;;;;;;;;.....;;;;;;;;;;;;;;;;;;
;..........................................................;;;;;;;;;;;;;;;;;;;;;.....;;;;;;;;;;;;;;;;;;
;........................................................;;;;;;;;;;;;;;;;;;;;;;.......;;;;;;;;;;;;;;;;;
;;;;;;;;;;;;;;;;;;;;;;;;;;;;...........................;;;;;;;;;;;;;;;;;;;;;;;.........;;;;;;;;;;;;;;;;
;;..;;;..;;.;;;;;;;;;;;;;;;;.........................;;;;;;;;;;;;;;;;;;;;;;;;...........;;;;;;;;;;;;;;;
;.;;.;.;;.;.;;;;;;;;;;;;;;;;........................;;........;;;;;;;;;;;;;;.............;;;;;;;;;;;;;;
;.;;;;.;;.;.;;;;;;;;;;;;;;;;;;.................................;;;;;;;;;;;;...............;;;;;;;;;;;;;
;.;..;.;;.;.;;;;;;;.....;;;;;;.................................;;;;;;;;;;;.................;;;;;;;;;;;;
;.;;.;.;;.;;;;;;;;;.....;;;;;;...;.........................;...;;;;;;;;;;...................;;;;;;;;;;;
;;..;;;..;;.;;;;;;;.....;;;;;;...;;;;;;;;;;;;;;;;;;;;;;;;;;;...;;;;;;;;;.....................;;;;;;;;;;
;;;;;;;;;;;;;;;;;;;.....;;;;;;.................................;;;;;;;;.......................;;;;;;;;;
;;;;;;;;;;;;;;;;;;;.....;;;;;;.................................;;;;;;;...........;;;...........;;;;;;;;
;;..........................;;.................................;;;;;;............;;;............;;;;;;;
;;..........................;;;;;;;;;;;;;;;;;;;;;;;;;;;;;;;;;;;;;;;;.............;;;.............;;;;;;
;;..........................;;;;;;;;;;;;;;;;;;;;;;;;;;;;;;;;;;;;;;;..............;;;..............;;;;;
;;;..;;;;;;;;;;;;;;.....;;;;;;;;;;;;;;;;;;;;;;;;;;;;;;;;;;;;;;;;;;...............;;;...............;;;;
;;;..;;;;;;;;;;;;;;.....;;;;;;................................................;;;;;;;;;.............;;;
;;;..;;;;;;;;;;;;;;.....;;;;;;.................................................;;;;;;;...............;;
;;;..;;;;;;;;;;;;;;.....;;;;;;..................................................;;;;;.................;
;;;..;;;;;;;;;;;;;;.....;;;;;;........;;;;;.....;;;;;;;;;;;;;;;;.................;;;.................;;
;;;..;;;;;;;;;;;;;;.....;;;;;;.......;;;;;;;..;;;;;;;;;;;;;;;;;;;.................;.................;;;
;;;..;;;;;;;;;;;;;;.....;;;;;;....;;;;;...;;;;;;;.........;;;;;;;;.................................;;;;
;;;..;;;;;;;;;;;;;;.....;;;;;;....;;;;.....;;;;............;;;;;;;;...............................;;;;;
;;;..;;;;;;;;;;;;;;.....;;;;;;..............................;;;;;;;;.............................;;;;;;
;;;..;;;;;;;;;;;;;;.....;;;;;;...............................;;;;;;;;...........................;;;;;;;
;;;..;;;;;;;;;;;;;;.....;;;;;;................................;;;;;;;;.........................;;;;;;;;
;;;..;;;;;;;;;;;;;;.....;;;;;;.................................;;;;;;;;.......................;;;;;;;;;
;;;..;;;;;;;;;;;;;;.....;;;;;;.................................;;;;;;;;;.....................;;;;;;;;;;
;;;..;;;;;;;;;;;;;;.....;;;;;;..........................;......;;;;;;;;;;...................;;;;;;;;;;;
;;;..;;;;;;;;;;;;;;.....;;;;;;;;;;;;;;;;;;;;;;;;;;;;;;;;;......;;;;;;;;;;;.....;;;;;;;.....;;;;;;;;;;;;
;;;..;;;;;;;;;;;;;;.....;;;;;;;;;;;;;;;;;;;;;;;;;;;;;;;;;......;;;;;;;;;;;;....;.....;....;;;;;;;;;;;;;
;;;..;;;;;;;;;;;;;;.....;;;;;;.................................;;;;;;;;;;;;;...;.....;...;;;;;;;;;;;;;;
;;;..;;;;;;;;;;;;;;.....;;;;;;.................................;;;;;;;;;;;;;;..;.....;..;;;;;;;;;;;;;;;
;;;..;;;;;;;;;;;;;;.....;;;;;;.................................;;;;;;;;;;;;;;;;;.....;;;;;;;;;;;;;;;;;;
;;;..;;;;;;;;;;;;;;.....;;;;;;.................................;;;;;;;;;;;;;;;.........;;;;;;;;;;;;;;;;
;;;..;;;;;;;;;;;;;;.....;;;;;;.................................;;;;;;;;;;;;;;;.........;;;;;;;;;;;;;;;;
;;;..;;;;;;;;;;;;;;.....;;;;;;................;;;...................................................;;;
;;;..;;;;;;;;;;;;;;.............................................................;;;;;...............;;;
;;;..;;;;;;;;;;;;;;.............................................................;;;;;...............;;;
;;;..;;;;;;;;;;;;;;..................;;;.......................;;;;;;;;;;;;;;;.........;;;;;;;;;;...;;;
;;;..;;;;;;;;;;;;;;.....;;;;;;..........................;;;....;;;;;;;;;;;;;;;;;;;;;;;;;;;;;;;;;;...;;;
;;;..;;;;;;;;;;;;;;.....;;;;;;...;;;.............;;;;;;;;......;;...........;;;;;;;;;;;;;...........;;;
;;;..;;;;;;;;;;;;;;.....;;;;;;.........;;;....................;;;...................................;;;
;;;..;;;;;;;;;;;;;;;;;;;;;;;;;...........;;;;;;..............;;;;...................................;;;
;;;..;;;;;;;;;;;;;;;;;;;;;;;;;............................;;;;;;;...................................;;;
;;;..;;;;;;;;;;;;;;;;;;;;;;;;;.........................;;;;;;;;;;;..;;;;;;;...............;;;;;;;;;;;;;
;;;..;;;;;;;;;;;;;;;;;;;;;;;;;.......................;;;;;;;;;;;;;..;;;;;;;;;;;;;;;;;;;;;;;;;;;;;;;;;;;
;;;..;;;;;;;;;;;;;;;;;;;;;;;;;;;;;;;;;;;;;;;;;;;;;;;;;;;;;;;;;;;;;..;;;;;;;;;;;;;;;;;;;;;;;;;;;;;;;;;;;
;;;..;;;;;;;;;;;;;;;;;;;;;;;;;;;;;;;;;;;;;;;;;;;;;;;;;;;;;;;;;;;;;..;;;;;;;;;;;;;;;;;;;;;;;;;;;;;;;;;;;
;;;..;;;............................................................;;;;;;;;;;;;;;;;;;;;;;;;;;;;;;;;;;;
;;;..;;;............................................................;;;;;;;;;;;;;;;;;;;;;;;;;;;;;;;;;;;
;;;..;;;............................................................;;;;;;;;;;;;;;;;;;;;;;;;;;;;;;;;;;;
;;;..;;;..;;;;;;;;;;;;;;;;;;;;;;;;;;;;;;;;;;;;;;;;;;;;;;;;;;;;;;;;;;;;;;;;;;;;;;;;;;;;;;;;;;;;;;;;;;;;;
;;;..;;;..;;;;;;;;;;;;;;;;;;;;;;;;;;;;;;;;;;;;;;;;;;;;;;;;;;;;;;;;;;;;;;;;;;;;;;;;;;;;;;;;;;;;;;;;;;;;;
;;;..;;;..;;;....................................................................;;;;;;;;;;;;;;;;;;;;;;
;;;..;;;..;;;......................................................................;;;;;;;;;;;;;;;;;;;;
;;;..;;;..;;;.......................................................................;;;;;;;;;;;;;;;;;;;
;;;..;;;..;;;..............................................;;;;;;;;;;;;;;;;;;........;;;;;;;;;;;;;;;;;;
;;;..;;;..;;;............................................;;;....;;;;;;;;;;;;;.........;;;;;;;;;;;;;;;;;
;;;..;;;..;;;..;;;;;;...........................;;;;;;..........;;;.........;.......................;;;
;;;..;;;..;;;.............;;;;;;..................;;............;;;.........;.......................;;;
;;;..;;;..;;;...............;;....................;;............;;;.........;.......................;;;
;;;..;;;..;;;...............;;.......;;;;;;.......;;............;;;.........;;;;;;;;;;;;;;;;;;;;;...;;;
;;;..;;;..;;;...............;;....................;;............;;;.........;.......................;;;
;;;..;;;..;;;;;............;;;....................;;;...........;;;.........;.......................;;;
;;;..;;;......................................................;;;;;.........;.......................;;;
;;;..;;;........................................................;;;.........;..;;;;;;;;;;;;;;;;;;;;;;;;
;;;..;;;........................................................;;;....;;...;..;;;;;;;;;;;;;;;;;;;;;;;;
;;;..;;;........................................................;;;....;....;..;;;;;;;;;......;;;;;;;;;
;;;..;;;;;;;;;;;;;;;;;;;;;;;;;;;;;;;;;;;;;;;;;;;;;;;;;;;;;;;;;;;;;;....;....;..;;;;;;;..........;;;;;;;
;;;..;;;;;;;;;;;;;;;;;;;;;;;;;;;;;;;;;;;;;;;;;;;;;;;;;;;;;;;;;;;;;;....;....;..;;;;;..............;;;;;
;;;..;;;;;;;;;;;;;;;;;;;;;;;;;;;;;;;;;;;;;;;;;;;;;;;;;;;;;;;;;;;;;;...;;....;..;;;;................;;;;
;;;..;;....;;....;;....;;....;;....;;....;;....;;....;;....;;....;;...;;....;..;;;..................;;;
;;;..;;....;;....;;....;;....;;....;;....;;....;;....;;....;;....;;...;;....;..;;....................;;
;;;..;;....;;....;;....;;....;;....;;....;;....;;....;;....;;....;;...;;....;..;;....................;;
;;;..;;;;..;;;;..;;;;..;;..;;;;;;..;;..;;;;;;..;;..;;;;..;;;;..;;;;..;;;....;..;;....................;;
;;;..................................................................;;;.......;;;;..;;;;;;;;;;;;;;;;;;
;;;..................................................................;;;.............;;;;;;;;;;;;;;;;;;
;;;..................................................................;;;.............;;;;;;;;;;;;;;;;;;
;;;;;;;;;;;;;;;;;;;;;;;;;;;;;;;;;;;;;;;;;;;;;;;;;;;;;;;;;;;;;;;;;;;;;;;;.............;;;;;;;;;;;;;;;;;;
;;;;;;;;;;;;;;;;;;;;;;;;;;;;;;;;;;;;;;;;;;;;;;;;;;;;;;;;;;;;;;;;;;;;;;;;;;;;;;;;;;;;;;;;;;;;;;;;;;;;;;;
;;;;;;;;;;;;;;;;;;;;;;;;;;;;;;;;;;;;;;;;;;;;;;;;;;;;;;;;;;;;;;;;;;;;;;;;;;;;;;;;;;;;;;;;;;;;;;;;;;;;;;;
;;;;;;;;;;;;;;;;;;;;;;;;;;;;;;;;;;;;;;;;;;;;;;;;;;;;;;;;;;;;;;;;;;;;;;;;;;;;;;;;;;;;;;;;;;;;;;;;;;;;;;;