;;;;;;;;;;;;;;;;;;;;;;;;;;;;;;;;;;;;;;;;;;;;;;;;;;;;;;;;;;;;;;;;;;;;;;;;;;;;;;;;;;;;;;;;;;;;;;;;;;;;;;;
;..................................................................................;;;;;;;;;;;;;;;;;;;;
;...................................................................................;;;;;;;;;;;;;;;;;;;
;....................................................................................;;;;;;;;;;;;;;;;;;
;....................................................................................;;;;;;;;;;;;;;;;;;
;...................................................................;;;;;;;;;;;......;;;;;;;;;;;;;;;;;;
;...............................................................;;;;;;;;;;;;;;;;.....;;;;;;;;;;;;;;;;;;
;.............................................................;;;;;;;;;;;;;;;;;;.....;;;;;;;;;;;;;;;;;;
;...................................;;;;;;..................;;;;;;;;;;;;;;;;;;;;.....;;;;;;;;;;;;;;;;;;
;..........................................................;;;;;;;;;;;;;;;;;;;;;.....;;;;;;;;;;;;;;;;;;
;........................................................;;;;;;;;;;;;;;;;;;;;;;.......;;;;;;;;;;;;;;;;;
;;;;;;;;;;;;;;;;;;;;;;;;;;;;...........................;;;;;;;;;;;;;;;;;;;;;;;.........;;;;;;;;;;;;;;;;
;;..;;;..;;.;;;;;;;;;;;;;;;;.........................;;;;;;;;;;;;;;;;;;;;;;;;...........;;;;;;;;;;;;;;;
;.;;.;.;;.;.;;;;;;;;;;;;;;;;........................;;........;;;;;;;;;;;;;;.............;;;;;;;;;;;;;;
;.;;;;.;;.;.;;;;;;;;;;;;;;;;;;.................................;;;;;;;;;;;;...............;;;;;;;;;;;;;
;.;..;.;;.;.;;;;;;;.....;;;;;;.................................;;;;;;;;;;;.................;;;;;;;;;;;;
;.;;.;.;;.;;;;;;;;;.....;;;;;;...;.........................;...;;;;;;;;;;...................;;;;;;;;;;;
;;..;;;..;;.;;;;;;;.....;;;;;;...;;;;;;;;;;;;;;;;;;;;;;;;;;;...;;;;;;;;;.....................;;;;;;;;;;
;;;;;;;;;;;;;;;;;;;.....;;;;;;....;;;;;;;;;;;;;;;;;;;;;;;;;....;;;;;;;;.......................;;;;;;;;;
;;;;;;;;;;;;;;;;;;;.....;;;;;;.................................;;;;;;;.........................;;;;;;;;
;;;;;;;;;;;;............;;;;;;.................................;;;;;;...........................;;;;;;;
;;;;;;;;;;;;............;;;;;;.................................;;;;;.............................;;;;;;
;;;;;;;;;;;;............;;;;;;;;;;;;;;;;;;;;;;;;;;;;;;;;;;;;;;;;;;;...............................;;;;;
;;;;;;;;;;;;;;;;;;;.....;;;;;;;;;;;;;;;;;;;;;;;;;;;;;;;;;;;;;;;;;;................;................;;;;
;;;;;;;;;;;;;;;;;;;.....;;;;;;....................................................;.................;;;
;;;;;;;;;;;;;;;;;;;.....;;;;;;..................................................;.;.;................;;
;;;;;;;;;;;;;;;;;;;.....;;;;;;...................................................;;;..................;
;;;;;;;;;;;;;;;;;;;.....;;;;;;........;;;;;......;;;;;;;;;;;;;;;..................;..................;;
;;;;;;;;;;;;;;;;;;;.....;;;;;;.......;;;;;;;...;;;;;;;;;;;;;;;;;;...................................;;;
;;;;;;;;;;;;;;;;;;;.....;;;;;;...;;;;;;...;;;;;;;.........;;;;;;;;.................................;;;;
;;;;;;;;;;;;;;;;;;;.....;;;;;;...;;;;;.....;;;;............;;;;;;;;...............................;;;;;
;;;;;;;;;;;;;;;;;;;.....;;;;;;..............................;;;;;;;;.............................;;;;;;
;;;;;;;;;;;;;;;;;;;.....;;;;;;...............................;;;;;;;;...........................;;;;;;;
;;;;;;;;;;;;;;;;;;;.....;;;;;;................................;;;;;;;;.........................;;;;;;;;
;;;;;;;;;;;;;;;;;;;.....;;;;;;.................................;;;;;;;;.......................;;;;;;;;;
;;;;;;;;;;;;;;;;;;;.....;;;;;;.................................;;;;;;;;;.....................;;;;;;;;;;
;;;;;;;;;;;;;;;;;;;.....;;;;;;.................................;;;;;;;;;;...................;;;;;;;;;;;
;;;;;;;;;;;;;;;;;;;.....;;;;;;;;;;;;;;;;;;;;;;;;;;;;;;;;;......;;;;;;;;;;;.....;;;;;;;.....;;;;;;;;;;;;
;;;;;;;;;;;;;;;;;;;.....;;;;;;;;;;;;;;;;;;;;;;;;;;;;;;;;;......;;;;;;;;;;;;....;.....;....;;;;;;;;;;;;;
;;;;;;;;;;;;;;;;;;;.....;;;;;;.................................;;;;;;;;;;;;;...;.....;...;;;;;;;;;;;;;;
;;;;;;;;;;;;;;;;;;;.....;;;;;;.................................;;;;;;;;;;;;;;..;.....;..;;;;;;;;;;;;;;;
;;;;;;;;;;;;;;;;;;;.....;;;;;;.................................;;;;;;;;;;;;;;;;;.....;;;;;;;;;;;;;;;;;;
;;;;;;;;;;;;;;;;;;;.....;;;;;;.................................;;;;;;;;;;;;;;;.........;;;;;;;;;;;;;;;;
;;;;;;;;;;;;;;;;;;;.....;;;;;;.................................;;;;;;;;;;;;;;;.........;;;;;;;;;;;;;;;;
;;;;;;;;;;;;;;;;;;;.....;;;;;;................;;;......................................;;;;;;;;;;;;;;;;
;;;;;;;;;;;;;;;;;;;.............................................................;;;;;..;;;;;;;;;;;;;;;;
;;;;;;;;;;;;;;;;;;;.............................................................;;;;;..;;;;;;;;;;;;;;;;
;;;;;;;;;;;;;;;;;;;..................;;;.......................;;;;;;;;;;;;;;;.........;;;;;;;;;;;;;;;;
;;;;;;;;;;;;;;;;;;;.....;;;;;;..........................;;;....;;;;;;;;;;;;;;;;;;;;;;;;;;;;;;;;;;;;;;;;
;;;;;;;;;;;;;;;;;;;.....;;;;;;...;;;.............;;;;;;;;......;;;;;;;;;;;;;;;;;;;;;;;;;;;;;;;;;;;;;;;;
;;;;;;;;;;;;;;;;;;;.....;;;;;;.........;;;....................;;;;;;;;;;;;;;;;;;;;;;;;;;;;;;;;;;;;;;;;;
;;;;;;;;;;;;;;;;;;;;;;;;;;;;;;...........;;;;;;..............;;;;;;;;;;;;;;;;;;;;;;;;;;;;;;;;;;;;;;;;;;
;;;;;;;;;;;;;;;;;;;;;;;;;;;;;;............................;;;;;;;;;;;;;;;;;;;;;;;;;;;;;;;;;;;;;;;;;;;;;
;;;;;;;;;;;;;;;;;;;;;;;;;;;;;;.........................;;;;;;;;;;;;;;;;;;;;;;;;;;;;;;;;;;;;;;;;;;;;;;;;
;;;;;;;;;;;;;;;;;;;;;;;;;;;;;;.......................;;;;;;;;;;;;;;;;;;;;;;;;;;;;;;;;;;;;;;;;;;;;;;;;;;
;;;;;;;;;;;;;;;;;;;;;;;;;;;;;;;;;;;;;;;;;;;;;;;;;;;;;;;;;;;;;;;;;;;;;;;;;;;;;;;;;;;;;;;;;;;;;;;;;;;;;;;
;;;;;;;;;;;;;;;;;;;;;;;;;;;;;;;;;;;;;;;;;;;;;;;;;;;;;;;;;;;;;;;;;;;;;;;;;;;;;;;;;;;;;;;;;;;;;;;;;;;;;;;
;;;;;;;;;;;;;;;;;;;;;;;;;;;;;;;;;;;;;;;;;;;;;;;;;;;;;;;;;;;;;;;;;;;;;;;;;;;;;;;;;;;;;;;;;;;;;;;;;;;;;;;
;;;;;;;;;;;;;;;;;;;;;;;;;;;;;;;;;;;;;;;;;;;;;;;;;;;;;;;;;;;;;;;;;;;;;;;;;;;;;;;;;;;;;;;;;;;;;;;;;;;;;;;
;;;;;;;;;;;;;;;;;;;;;;;;;;;;;;;;;;;;;;;;;;;;;;;;;;;;;;;;;;;;;;;;;;;;;;;;;;;;;;;;;;;;;;;;;;;;;;;;;;;;;;;
;;;;;;;;;;;;;;;;;;;;;;;;;;;;;;;;;;;;;;;;;;;;;;;;;;;;;;;;;;;;;;;;;;;;;;;;;;;;;;;;;;;;;;;;;;;;;;;;;;;;;;;
;;;;;;;;;;;;;;;;;;;;;;;;;;;;;;;;;;;;;;;;;;;;;;;;;;;;;;;;;;;;;;;;;;;;;;;;;;;;;;;;;;;;;;;;;;;;;;;;;;;;;;;
;;;;;;;;;;;;;;;;;;;;;;;;;;;;;;;;;;;;;;;;;;;;;;;;;;;;;;;;;;;;;;;;;;;;;;;;;;;;;;;;;;;;;;;;;;;;;;;;;;;;;;;
;;;;;;;;;;;;;;;;;;;;;;;;;;;;;;;;;;;;;;;;;;;;;;;;;;;;;;;;;;;;;;;;;;;;;;;;;;;;;;;;;;;;;;;;;;;;;;;;;;;;;;;
;;;;;;;;;;;;;;;;;;;;;;;;;;;;;;;;;;;;;;;;;;;;;;;;;;;;;;;;;;;;;;;;;;;;;;;;;;;;;;;;;;;;;;;;;;;;;;;;;;;;;;;
;;;;;;;;;;;;;;;;;;;;;;;;;;;;;;;;;;;;;;;;;;;;;;;;;;;;;;;;;;;;;;;;;;;;;;;;;;;;;;;;;;;;;;;;;;;;;;;;;;;;;;;
;;;;;;;;;;;;;;;;;;;;;;;;;;;;;;;;;;;;;;;;;;;;;;;;;;;;;;;;;;;;;;;;;;;;;;;;;;;;;;;;;;;;;;;;;;;;;;;;;;;;;;;
;;;;;;;;;;;;;;;;;;;;;;;;;;;;;;;;;;;;;;;;;;;;;;;;;;;;;;;;;;;;;;;;;;;;;;;;;;;;;;;;;;;;;;;;;;;;;;;;;;;;;;;
;;;;;;;;;;;;;;;;;;;;;;;;;;;;;;;;;;;;;;;;;;;;;;;;;;;;;;;;;;;;;;;;;;;;;;;;;;;;;;;;;;;;;;;;;;;;;;;;;;;;;;;
;;;;;;;;;;;;;;;;;;;;;;;;;;;;;;;;;;;;;;;;;;;;;;;;;;;;;;;;;;;;;;;;;;;;;;;;;;;;;;;;;;;;;;;;;;;;;;;;;;;;;;;
;;;;;;;;;;;;;;;;;;;;;;;;;;;;;;;;;;;;;;;;;;;;;;;;;;;;;;;;;;;;;;;;;;;;;;;;;;;;;;;;;;;;;;;;;;;;;;;;;;;;;;;
;;;;;;;;;;;;;;;;;;;;;;;;;;;;;;;;;;;;;;;;;;;;;;;;;;;;;;;;;;;;;;;;;;;;;;;;;;;;;;;;;;;;;;;;;;;;;;;;;;;;;;;
;;;;;;;;;;;;;;;;;;;;;;;;;;;;;;;;;;;;;;;;;;;;;;;;;;;;;;;;;;;;;;;;;;;;;;;;;;;;;;;;;;;;;;;;;;;;;;;;;;;;;;;
;;;;;;;;;;;;;;;;;;;;;;;;;;;;;;;;;;;;;;;;;;;;;;;;;;;;;;;;;;;;;;;;;;;;;;;;;;;;;;;;;;;;;;;;;;;;;;;;;;;;;;;
;;;;;;;;;;;;;;;;;;;;;;;;;;;;;;;;;;;;;;;;;;;;;;;;;;;;;;;;;;;;;;;;;;;;;;;;;;;;;;;;;;;;;;;;;;;;;;;;;;;;;;;
;;;;;;;;;;;;;;;;;;;;;;;;;;;;;;;;;;;;;;;;;;;;;;;;;;;;;;;;;;;;;;;;;;;;;;;;;;;;;;;;;;;;;;;;;;;;;;;;;;;;;;;
;;;;;;;;;;;;;;;;;;;;;;;;;;;;;;;;;;;;;;;;;;;;;;;;;;;;;;;;;;;;;;;;;;;;;;;;;;;;;;;;;;;;;;;;;;;;;;;;;;;;;;;
;;;;;;;;;;;;;;;;;;;;;;;;;;;;;;;;;;;;;;;;;;;;;;;;;;;;;;;;;;;;;;;;;;;;;;;;;;;;;;;;;;;;;;;;;;;;;;;;;;;;;;;
;;;;;;;;;;;;;;;;;;;;;;;;;;;;;;;;;;;;;;;;;;;;;;;;;;;;;;;;;;;;;;;;;;;;;;;;;;;;;;;;;;;;;;;;;;;;;;;;;;;;;;;
;;;;;;;;;;;;;;;;;;;;;;;;;;;;;;;;;;;;;;;;;;;;;;;;;;;;;;;;;;;;;;;;;;;;;;;;;;;;;;;;;;;;;;;;;;;;;;;;;;;;;;;
;;;;;;;;;;;;;;;;;;;;;;;;;;;;;;;;;;;;;;;;;;;;;;;;;;;;;;;;;;;;;;;;;;;;;;;;;;;;;;;;;;;;;;;;;;;;;;;;;;;;;;;
;;;;;;;;;;;;;;;;;;;;;;;;;;;;;;;;;;;;;;;;;;;;;;;;;;;;;;;;;;;;;;;;;;;;;;;;;;;;;;;;;;;;;;;;;;;;;;;;;;;;;;;
;;;;;;;;;;;;;;;;;;;;;;;;;;;;;;;;;;;;;;;;;;;;;;;;;;;;;;;;;;;;;;;;;;;;;;;;;;;;;;;;;;;;;;;;;;;;;;;;;;;;;;;
;;;;;;;;;;;;;;;;;;;;;;;;;;;;;;;;;;;;;;;;;;;;;;;;;;;;;;;;;;;;;;;;;;;;;;;;;;;;;;;;;;;;;;;;;;;;;;;;;;;;;;;
;;;;;;;;;;;;;;;;;;;;;;;;;;;;;;;;;;;;;;;;;;;;;;;;;;;;;;;;;;;;;;;;;;;;;;;;;;;;;;;;;;;;;;;;;;;;;;;;;;;;;;;
;;;;;;;;;;;;;;;;;;;;;;;;;;;;;;;;;;;;;;;;;;;;;;;;;;;;;;;;;;;;;;;;;;;;;;;;;;;;;;;;;;;;;;;;;;;;;;;;;;;;;;;
;;;;;;;;;;;;;;;;;;;;;;;;;;;;;;;;;;;;;;;;;;;;;;;;;;;;;;;;;;;;;;;;;;;;;;;;;;;;;;;;;;;;;;;;;;;;;;;;;;;;;;;
;;;;;;;;;;;;;;;;;;;;;;;;;;;;;;;;;;;;;;;;;;;;;;;;;;;;;;;;;;;;;;;;;;;;;;;;;;;;;;;;;;;;;;;;;;;;;;;;;;;;;;;
;;;;;;;;;;;;;;;;;;;;;;;;;;;;;;;;;;;;;;;;;;;;;;;;;;;;;;;;;;;;;;;;;;;;;;;;;;;;;;;;;;;;;;;;;;;;;;;;;;;;;;;
;;;;;;;;;;;;;;;;;;;;;;;;;;;;;;;;;;;;;;;;;;;;;;;;;;;;;;;;;;;;;;;;;;;;;;;;;;;;;;;;;;;;;;;;;;;;;;;;;;;;;;;